60000000046000000000000000000000000000000000000004
60000000046000000000000000000000000000000000000004
60000000046000000000000000000000000000000000000004
60000000046000000000000000000000000000000000000004
60000000079000000000000000000122300000000000000004
60022200000000000000000000012b55a23000000000000004
600000022222220000000000001b555555a300000000000004
60000000000000013000000001b55555555a30000000000004
a22222222222222ba22222022b5555555555a222222222222b
55555555555555555555550555555555555555555555555555
