600000000460000000000000004
600000000460000000000000004
600000000460000000000000004
600000000460000000000000004
600000000790000000000000004
600222000000000000000000004
600000022222220000000000004
600000000000000130000000004
a22222222222222ba222222222b
555555555555555555555555555
